111111111
100000P011
10E000001
100000C01
111111111