111111111
10X001
100000001
10C00P001
100000E01
111111111