1111111111
100P00E001
1000000001
1E00000C01
1111111111