111111111
10P100C01
111000001
1E0000001
111111111