1111111
100E001
10CP001
1111111