11111111111111
11C001100C00P1
10X00000001C01
100000100X0001
10110C00000001
10C0110C0X0011
1E00C001100001
11111111111111