11111111111111
101C0X0110C001
1X000000C0X001
11100000100001
100C00P00E10C1
10010011100001
1CX0000C0000X1
11111111111111