11111111111111
1EX000C0001001
1X0010X0001001
10000C00000C01
1110X000C00001
1C0000000XC001
1C0X10010010P1
11111111111111