11111111111111
1P00110000C001
100000C0001001
100100000000C1
100000C0000001
10C00011110001
111000C010C0E1
11111111111111