1111111
100ECP1
1000001
1C0X001
1000001
1X0C001
1111111