111111111111111111
1000000000E0000001
10000C000000000001
1000000000P0000001
10000C000000000001
111111111111111111
