1111111
1X0ECP1
1000001
1C00001
1000001
1111111