11111111111
1000000I001
10000000001
1000I000001
10000000001
100P0000001
10000000001
100I000E001
11111111111
