1111111
10CPE01
1000001
1000001
1000001
1000001
1000001
1000001
1000001
1111111
