1111111111111111111111111
1C000000X0000000X00000001
1000000000P0000000000C001
10000X00C0000000000000X01
10C0000000000X000E000X001
1111111111111111111111111
