111111111
1P0001C01
1010C0011
1C0000001
1C00111C1
11C00C0E1
111111111