1111111111111111111111111
1I00000000000000000000001
1000000000P0000000000I001
1000000I00000000000000001
10I00000000000000E0000001
1111111111111111111111111
