1111111111111111111111111
1C00000000000000X00000001
1000000000P0000000000C001
10000X00C0000000000000001
10C0000000000X000E0000001
1111111111111111111111111
