11111111111
1C00P000C01
1X000000001
1000CE00X01
100000C0001
1C0X0000001
11111111111