11111111111111
10I00000000001
10000000000C01
11111000000001
1P00E000000001
11111111111111
