111111111111
10000000X001
1000P00C0101
1C00000001C1
1X0110000001
100000CE0101
111111111111