111111111111
10P010000001
111110000001
100000000001
100000000001
111111111111
