111111111111
10E000000I01
1P00000E0001
111111111111
