111111111
10E000000
10C000P01
111111111